NO  ./texture/wolfenstein/bluestone.xpm
SO 		./texture/wolfenstein/colorstone.xpm
WE ./texture/wolfenstein/eagle.xpm
EA ./texture/wolfenstein/redbrick.xpm
F   220,	100,0
C 		 225 ,30,0

1111111111
110S000001
1100000001
1000000001
1000100001
1000100001
1000000001
1000000001
1000000001
1111111111
