
NO ./texture/wolfenstein/bluestone.xpm
SO ./texture/wolfenstein/colorstone.xpm
WE ./texture/wolfenstein/eagle.xpm
EA ./texture/wolfenstein/redbrick.xpm

11111111111111111111
11000000000000000011
1100000001111111111111
1000N00001
1000100001
1000100001
1000000001
1000000001
1000000001
1111111111



