1111111111
1N00000001
1000000001
1000000001
1000100001
1000100001
1000000001
1000000001
1000000001
10000000011111111111111111
10000000000000000000000001
10000000000000000000000001
10000000000000000000000001
11111111111111111111111111
