                               11111111111111111
							   100000S0000000001
							   10000000000000001
							   10000000000000001
							   10000000000000001
111111111111111111111111111111110000000000000001
100000000000000000000000000000000000000000000001
100000000000000000000000000000000000000000000001
111001111111111111111111111111111111111111111111111
  1111
